MMMMMMMMMMMMMMMMMMMMMMMMMMMM
+------------++------------+
|                          |
| +--+ ++ +------+ ++ +--+ |
|         |MMMMMM|         |
+----+ ++ |MMMMMM| ++ +----+
MMMMM| || +------+ || |MMMMM
MMMMM| ||          || |MMMMM
MMMMM| |+--+ ++ +--+| |MMMMM
+----+ |+--+ || +--+| +----+
|      ||    ||    ||      |
| +--+ ++ +--++--+ ++ +--+ |
|         |MMMMMM|         |
| +--+ ++ +------+ ++ +--+ |
|                          |
+------------++------------+
MMMMMMMMMMMMMMMMMMMMMMMMMMMM